1111111111111111111111111
1322222222222525115225251
1211111111111212112115151
1522222222251212112111111
1211111111111522225222551
1551552222225511111111211
1211121111115522225221251
1551552252511111112111111
1211211121211111555525251
1515522252515111211514151
1212111111215222551144411
1522222222512111111111151
1211112111115515222215251
152511-115111115251525251
12151---15252511152515251
12111-0-11122215251212121
15251---15552512111525121
1525111111511115551111121
1525515155522151522525251
1211212112121111211121121
1322515225222222525152231
1111111111111111111111111