1111111111111111111111111
1322222222222525115225231
1211111111111212112112121
1522222222251212112112121
1211111111111522225225551
1551552222225511111111211
1211121111115522225222551
1551552252511111112111121
1211211121211111555525251
1515522252515111211514111
1212111111215222551144411
1522222222512111121111111
1211112111115515252215251
152511-115111115251525251
12121---15252511152515251
12121-0-11121215251212121
15251---15552512111525251
1525111111511115551111121
1525515155522151522525251
1211212112121121211121121
1322515225222252522252231
1111111111111111111111111