11111111111111111111111111111111111111111111111111
24333333333333337666733333333333333333333333333342
23666666666663737666736666666366666666666666666362
23333333333373736666636666666333366666663333337332
23366666666673333333333333333333333333333666366362
23373333333333666666666663666663666666663333333332
23666366666633333333333373733333733333333337337332
23373333333766666666663766663366666333366666667362
23673666333766667366733733337337333333733333337632
23367333333333337333333333336666336663336666637362
23733376666666666666666666633333337373733373337632
23666663733333333333733333337337337373736666637362
23333333736666666666733733736666337373733373337332
23666666633333333333333733733333333333666366367632
23333333333333333333666666666366373733333333333332
26636633333336666633766666667373373737336666666632
23333733666637666733766666667373673366637373737332
23373733333737666733666666666373333333337333333332
23666666666737666733333333333333336666666666666662
23333333333736666636666666666663333373333333333332
23666366636633333333333377333333666663366363663632
23737333333333366673666666666663333333373333333332
23736666633737333373333333333333333333333636636362
23733333333737663673736656637333733733373333337332
26636666663737333373737555737336666663366663333362
23337333333736666663736666637333733333333333666332
23667636666733733333733333337333766666666663333332
23337333333763733333666636666333733337373733666662
23666363663333733333333333333333333333333333333332
23333333333363363666637766366666666336666666666662
23666663666333733373337733333337333333333333333332
23733333333333733373667766363637366663666666666632
237366-6636666733373333333333337333333373333333332
23737---733333766333733366636366666366673666636662
23667-0-766333733373737333333333737333373333333332
23337---733333736673337336666663333366676666636662
23336666663666633376667337333336666333366666633332
26366666337333333373737337666637636666333336766632
26333337337336666673737337333333333666666636733332
26373737337337373333333336666637666333333336736662
23666666337333333373737373333336666666366666633332
23737373337366666666666666663733333333337373336662
23333333337333333333333333333733366666637373733332
23666633333336666636666663666736673373333333333332
23733337366663333333333333333733376376666663666732
23663737333373666666666666666736637333333333733732
23333737666373333333333333333333337373666663333732
23666637373366666666666666666666637366736673666632
24333337333333333333333333333333333333733333733342
11111111111111111111111111111111111111111111111111