1111111111111111111111111
1322225111115251111111531
1152515222225122--0-11551
1121212111112121111111211
1152525221512121522251211
1111111121212121211121211
1152515252515251522252511
1121212111111111211111211
1121525152225251522251211
1121111121112121111111211
1152225151525151522222511
1111112111211111211121111
1152515251215251222152511
1111211121211121211111211
1152522252515251215251211
1121111121112111212111211
1121215251525152525152511
1121212111211121111121111
1152515251215121525121511
1121411121212121212121211
1121444121215251212152211
1121111121211111212111211
1155222251522222515222551
1325115252511152525111531
1111111111111111111111111