11111111111111111111111111111111111111111111111111
24333333333333387666783333333833333333333333333842
23666666666668737666736666666366666666666666666362
28333333333873736666636666666833866666668333887882
23666666666678338333383338333838333333338666366362
28878833333388666666666663666663666666668333883882
23666366666688333333338873738838783333338387887882
28878833838766666666663766668866666333866666667362
23678666363766667866733783387887833338733333337882
28867833838333387833388383386666336668386666637632
23783876666666666666666666683333387873783878387882
23666668783333333338788388387337337373736666637362
28333338736666666666733733736666337373783878887882
23666666683333333333388788783333338838666366367632
28383388333333333333666666666366373783883333833382
26636688383386666688766666667378873787836666666632
28388733666637666733766666667373678866637878787832
23373788338737666733666666666378388833387838383382
23666666666737666788333333333833386666666666666662
28833833338736666636666666666668383878833833338382
23666366636683333388333877833333666663366363663632
23787833388333366673666666666668333333378838338882
23736666633737333378383383383333333388838636636362
28783333388737663673736656637338788783378383387882
26636666663737333373737555737336666663366668333862
28387883338736666663736666637338783338833338666882
23667636666788783333783383387333766666666668333882
28387333333763733333666636666333733337373783666662
23666363663333738333383383833888333883333388333382
28333338333368863666637766366666666336666666666662
23666663666333788878387783833387833888333333333382
23783333383338733373667766363637366663666666666632
237366-6636666783878383833388887833838878333383382
23787---783838766838783866636366666366673666636662
23667-0-766333783873737883383838787833878333383382
28387---788838736678387336666668383866676666636662
28886666668666683876667337833386666833866666683382
26366666887833383878787337666637686666833386766632
26838387337336666673737337833383388666666636783382
26878787337337873338383886666637666833833386736662
28666666337833833378787878338386666666366666683382
23787878887366666666666666663783833333887878836662
28383833337883333383333338338783866666637373783382
23666638883886666636666663666736678878383838883382
23788387366668333383333338338783876376666663666732
23663737833873666666666666666736687838333338788732
28338737666378333333333333333383387378666668388732
23666637878866666666666666666666637366786673666632
24333387838833333333333333333333383838783338783342
11111111111111111111111111111111111111111111111111